#########################################
          ########                  #####
######### ######## ################    ##
##### ###          #########        #####
#     ### ######################### #####
# ####### ###############           #####
# #######       ######### #########     #
# ######## #### ######### #### #### #####
# #        #### ######### #### #### #####
# ## ########## ############## ##########
# ## ####                               #
# ## ################### ################
#    ################### ##########     #
#### ################### ########## ### #
#### ################### ########## ### #
####       #############            ### #
#######################################  
#########################################