#######################################################################################################################################################
S        #                 #     #        #           #        #                                   #  #     #  #     #           #        #  #        #
#######  #  ####  #  #######  #######  ####  ####  ##########  #  #  #############  ##########  ####  #  ####  ####  ##########  #######  #  #  ####  #
#     #  #  #     #     #  #        #        #  #     #           #     #     #     #  #  #  #  #           #                       #  #     #     #  #
#  ####  ####  #  #######  ####  ####  #  #  #  #######  #######  ####  #  #  #  ####  #  #  ##########  ####  ####  #  #  #  #######  #  ##########  #
#  #     #     #  #           #     #  #  #        #  #  #     #     #  #  #                 #              #     #  #  #  #           #  #           #
#  #  #######  #  #######  #  ####  #######  ####  #  ####  #  #  #  #  ####  #########################  #  #  #  ####  #############  #  #  ####  ####
#           #  #  #        #  #              #           #  #     #  #  #     #     #  #  #           #  #     #     #  #        #  #  #  #     #  #  #
#  #  #  ####  ##########  ####  #############  ####  #######  #  ##########  #  ####  #  ##########  #  #  ####  #  ##########  #  ####  #  #######  #
#  #  #     #     #     #  #              #     #  #           #  #  #     #     #     #  #           #  #  #     #           #                 #  #  #
#  ##########  ####  #  #  #  #  #  #  ##########  #  ####  ####  #  ####  #  #  ####  #  #######  ####  ####  ##########  #  #######  #######  #  #  #
#  #  #  #           #     #  #  #  #     #     #        #     #  #           #        #        #  #     #     #  #  #     #  #              #  #  #  #
#  #  #  ####  ####  #######  #  #  #  ####  #######  #  #  ####  ######################  ####  #  #######  #  #  #  #  #######  ####  ####  ####  #  #
#     #     #     #     #  #  #  #  #  #        #     #  #  #           #           #     #           #     #        #  #  #  #  #  #     #  #        #
#  ####  #  #  ####  #  #  ##########  #  ####  #  #  #######  ###################  ##########  ####  #  ####  ##########  #  ####  #  #######  #######
#     #  #     #     #        #     #  #  #        #  #     #     #  #                 #           #  #  #                 #        #  #  #           #
####  #  #######  #######  #  ####  ####  ####  #  ####  ####  #  #  #######  ###################  #  #  ####  #######  #  #  #  ####  #  #  ####  ####
#  #  #        #     #     #     #        #     #     #     #  #  #           #  #              #  #  #  #  #        #  #  #  #  #     #     #        #
#  #  #  ################  #  ##########  ####  #  #######  ####  #######  ####  #  ####  ####  ####  ####  #  ##########  ####  ####  #  #############
#           #  #        #  #     #     #     #  #              #     #                 #  #              #        #     #  #                 #        #
#  #######  #  #  #############  ####  ####  ##########  #  #######  #  ###################  #  #######  ##########  #  #  ##########  ####  #  ####  #
#  #  #  #     #  #  #  #  #  #        #  #        #     #  #  #     #              #     #  #     #  #              #  #     #     #     #        #  #
#  #  #  ####  #  #  #  #  #  #######  #  #  ####  ##########  #  #  ##########  #######  ##########  ######################  ####  #  #  #  ####  #  #
#           #  #        #  #     #           #  #  #           #  #  #     #           #              #  #     #        #     #     #  #  #     #  #  #
#  #############  ####  #  ####  #  ####  #  #  ####  #  ##########  #  #############  ####  #  #######  #  ##########  #  #######  #  #######  #######
#              #  #  #     #        #     #        #  #     #  #  #  #  #     #  #        #  #  #  #     #     #                 #  #  #        #     #
##########  #######  #  ##########  ####  #######  #  #  ####  #  #  #  ####  #  ####  #  #  #  #  #  #######  ##########  #######  #  ####  #  ####  #
#        #        #           #  #     #     #        #     #  #  #        #           #  #  #        #  #  #           #     #     #     #  #     #  #
#  #  ####  #######  ####  ####  #  #######  #  #  #######  #  #  ####  #  #  ####  ####  #######  #  #  #  #######  #######  #  #  #  ####  #######  #
#  #        #     #  #        #  #        #  #  #  #  #     #  #     #  #  #  #     #        #     #        #  #     #     #     #     #           #  #
##########  #  ####  ##########  #  #######  #######  ####  #  ####  #######  #  #######  #  ##########  ####  ####  ####  #  #  ####  #######  ####  #
#              #  #        #              #  #     #  #  #  #  #  #     #  #  #  #  #     #  #     #                    #     #  #           #        #
####  #  ####  #  #  ##########  #  ####  #######  #  #  #  #  #  #  ####  ####  #  ####  #  #  #######  #  ################  #######  #############  #
#  #  #  #                    #  #  #  #           #  #  #              #     #  #        #              #  #        #  #     #           #  #        #
#  ##########  ####  #############  #  #  ####  ####  #  #  #  #  #######  #######  #  #  ####  #  ##########  ####  #  ####  ####  ####  #  #######  #
#           #     #     #           #  #  #  #  #        #  #  #     #           #  #  #  #     #  #  #     #     #  #        #     #        #     #  #
#  ####  #  ###################  #  #  ####  ##########  ####  ####  ####  #  ####  #  ##########  #  #  ##########  #  #  ####  #  #######  #  ####  #
#     #  #  #        #        #  #  #              #     #     #     #     #  #  #  #     #     #  #        #  #  #     #     #  #     #     #        #
#  #######  #  #  #  ####  ####  #######  ####  #  #  ################  #######  #######  #  #  ####  #  ####  #  ##########  #######  #  #  #  ####  #
#  #     #     #  #              #        #  #  #  #  #                 #                 #  #        #        #           #     #  #  #  #  #     #  #
####  ####  #############  #######  #  ####  #  ####  ####  #  #  #  #  #  #############  #  #  #######  #  #############  #  ####  ####  ####  #######
#                 #  #  #  #  #     #  #              #  #  #  #  #  #        #              #  #        #  #  #  #  #     #     #  #     #           #
#  #######  ####  #  #  #  #  #######  ##########  ####  #########################  ##########  #############  #  #  #  ####  ####  #############  ####
#     #     #     #     #              #              #              #  #                    #     #  #        #  #              #  #     #           #
#  #  #  #  #  ####  #######  #  #  #############  ##########  #######  ####  #  #  #######  ####  #  ####  #  #  ####  ####  #  #  ####  #  #######  #
#  #  #  #  #           #     #  #     #     #           #  #              #  #  #  #           #           #     #     #     #        #  #        #  #
#  ####  #  #######  #  ####  ##########  ####  ####  ####  ####  ##########  #############  ##########  ################  ####  ####  #  #######  ####
#  #  #  #     #     #     #     #           #  #                    #     #  #  #  #     #        #  #     #  #           #        #  #     #        #
####  #  #  #  #  ####  #  #  #######  #  #  #  ####  #######  #  #  #  ####  #  #  #  ####  #  #  #  #  #  #  #  #  #  ####  #  ####  #  ####  #######
#  #  #  #  #  #  #     #  #     #     #  #  #  #  #     #  #  #  #        #  #        #     #  #  #  #  #  #     #  #     #  #  #  #  #           #  #
#  #  #  ################  #  #  ####  ##########  #######  ####  ####  ####  #  ####  ####  #######  #######  #######  ##########  #  #  #  ####  #  #
#     #           #  #     #  #                       #     #     #     #     #     #  #              #     #        #  #        #  #  #  #     #     #
#  #  #  ##########  ##########  #  ####  #######  #  #  ################  ####  ####  #  #############  #  #######  ##########  #  ####  #############
#  #           #  #     #        #  #     #        #        #     #     #  #     #  #  #  #           #  #  #  #        #  #     #           #        #
#  ####  ####  #  ####  #  #  ####  #######  ####  ####  #  ####  #  #  #######  #  #  #  #######  #######  #  ##########  ####  ####  #############  #
#  #  #  #        #        #     #     #     #  #  #     #     #  #  #     #  #  #           #  #                 #     #     #        #     #  #  #  #
####  #  #########################  ##########  #  ####  ####  #  #######  #  ##########  ####  ####  #######  #######  ####  ####  #######  #  #  #  #
#        #     #  #        #           #     #        #  #     #           #  #  #           #              #  #        #           #        #     #  #
####  #  #  ####  ####  #  ####  #######  #  #  #  ##########  ##########  #  #  #######  #######  #  ##########  #  #  #  #######  #  #  #  #  ####  #
#     #     #  #  #  #  #     #        #  #     #  #        #           #     #                 #  #  #        #  #  #  #  #        #  #  #           #
#  ##########  #  #  #  ##########  ################  #######  #  ####  #  ####  #############  ####  #  ####  #  #  #######  #######  #  #######  ####
#  #  #  #  #  #     #           #                 #     #  #  #  #  #                       #        #     #     #        #        #  #  #        #  #
#  #  #  #  #  #  ####  #  ##########  ####  #######  #  #  #  ####  #######  ####  #######  #######  ####  #  #######  #  #  #  ##########  #  #  #  #
#  #     #  #  #     #  #  #        #     #     #     #  #     #  #     #     #  #  #        #           #  #  #        #  #  #           #  #  #     #
####  #  #  #  #  #  ####  #  #  ####  #############  #  #  #  #  ####  #  #  #  #  ####  ####  #######  ####  #  #  ####  #############  ####  ####  #
#     #  #        #  #  #  #  #  #        #        #  #  #  #        #     #  #     #     #  #     #        #  #  #  #  #  #        #     #        #  #
#  #  ####  ##########  #  ####  #######  #  #######  #  #######  ##########  ####  #  ####  ##########  #######  #  #  #  #  ####  #  ####  ##########
#  #     #           #  #  #  #     #           #     #  #  #        #        #  #  #        #     #           #  #     #     #  #  #           #     #
####  #  #  #######  #  #  #  #  #######  ####  #  #  ####  ####  #  ####  ####  ####  ##########  #  #######  #######  ####  #  ####  #######  #  ####
#  #  #           #  #  #  #        #  #  #  #  #  #  #  #  #  #  #     #  #        #  #  #        #  #  #        #        #  #              #        #
#  #  #  ##########  #  #  #  #######  #  #  #  #  ####  #  #  #  #############  #  ####  #  ####  ####  #  ####  ####  ##########  #  #  #  #######  #
#     #  #     #     #              #  #  #           #              #        #  #     #     #     #     #  #     #  #  #     #     #  #  #        #  #
#  ##########  #  #######  #  #######  #  #  ####  ####  ####  ####  ####  ####  #  #  ####  ####  ####  #  #  #  #  #  #  #  #  #  #  #  ####  #######
#     #  #  #           #  #  #     #     #  #        #  #     #                 #  #  #  #  #           #  #  #           #  #  #  #  #     #        #
#######  #  #######  ####  #  ####  #  ####  #  #######  ####  #  #######  #  ##########  ####  #  #  #######  #  #  #######  #  ####  ####  ####  #  #
#                       #  #     #     #     #  #     #     #  #  #        #     #     #        #  #  #  #     #  #     #        #        #     #  #  #
#############  #######  #######  #  ####  ####  #  #  ####  ####  #######  #  #  #  #######  #######  #  #  ##########  #######  #############  ####  #
#     #           #  #     #        #     #        #     #  #        #     #  #  #  #        #  #     #     #        #     #  #  #     #        #  #  #
#  ####  ##########  #  #  #  ####  #  #  #  ##########  #######  ##########  ####  ####  ####  #  ####  ####  #############  ####  #  #  #######  ####
#     #  #     #  #     #     #  #  #  #  #  #  #  #     #     #     #        #        #  #           #        #        #     #     #  #              #
####  #######  #  ####  ####  #  #######  ####  #  #  ####  #######  #  #############  #######  ####  #######  #######  #  ####  #  #  #############  #
#  #  #           #     #  #     #  #           #  #  #        #  #  #  #           #     #        #        #     #     #  #     #  #     #  #  #     #
#  #  #  #  #  ##########  #  ####  #  ####  ####  #  ####  ####  #  #############  ####  #  ####  #  ################  #  #  #############  #  ####  #
#        #  #     #              #  #     #  #           #  #     #  #              #           #  #        #        #  #  #        #        #     #  #
####  ###################  #######  ####  #  ####  ####  #  ####  #######  #  ####  #  ######################  ####  #  #  #  ##########  #  #  #  #  #
#              #     #  #        #  #     #  #  #  #           #        #  #  #              #     #        #     #     #  #           #  #     #     #
#  #######  #######  #  #  #  #  #  ####  ####  #  #######  #######  #  #  #  #############  #  ####  #############  ####  #  ####  ####  #############
#        #           #     #  #  #     #  #           #           #  #     #  #        #  #  #        #  #  #     #     #     #  #  #  #  #           #
#  ##########  #######  #  ##########  ####  #######  #######  ##########  ####  #  ####  #  #  ####  #  #  #  #######  #  #  #  ####  #  ##########  #
#           #  #     #  #     #  #  #  #        #  #  #  #        #     #  #     #  #  #        #  #  #     #           #  #        #                 #
#############  #  #  #  #  #  #  #  #  #  ####  #  ####  #  ##########  #  #  #######  ##########  #######  #  #  #  #  #######  #  #  ####  ####  ####
#     #           #     #  #  #     #     #  #  #  #     #           #                    #  #              #  #  #  #  #  #     #     #     #  #     #
#  ####  ##########  ####  #######  #######  ####  #  #  #  ####  ##########  ####  #  ####  #  #  ####  #  #######  ####  #  ################  ####  #
#     #     #           #     #  #        #     #  #  #     #  #  #              #  #  #        #     #  #  #        #     #        #              #  #
#  #######  ####  #######  #  #  #  ##########  #  ####  #  #  ##########  ####  ################  #######  #  ####  ####  #  ####  #  ####  ####  #  #
#     #        #  #  #  #  #  #           #     #        #  #                 #     #  #           #        #  #     #        #     #  #     #  #  #  #
####  #######  ####  #  ####  #  #  #  ####  #######  ####  #  #  #######  #######  #  #  #  ##########  #######  ####  #######  ####  #  ####  #  #  #
#           #  #  #  #        #  #  #  #     #  #  #  #        #        #     #  #     #  #  #                       #        #     #  #        #     #
####  #  ####  #  #  ####  #  #  #  #  #  ####  #  #  ##########  #  #  ####  #  #  #  ####  #######  #  #  #  #  #  #  #######  ####  #  ##########  #
#     #              #     #     #  #              #           #  #  #     #     #  #     #     #     #  #  #  #  #     #        #     #  #           E
#######################################################################################################################################################