#########################################
S         ########                  #####
######### ######## ################    ##
##### ###          #########        #####
#     ### ######################### #####
# ####### ###############           #####
# #######       ######### #########     #
# ######## #### ######### #### #### #####
# #        #### ######### #### #### #####
# ## ########## ############## ##########
# ## ####                               #
# ## ################### ################
#    ################### ##########     #
#### ################### ########## ### #
#### ################### ########## ### #
####       #############            ### #
####################################### E
#########################################